********************
****############****
********************
********************
**#**************#**
**#**************#**
**#**************#**
**#**************#**
**#**************#**
**#**************#**
**#**************#**
**#**************#**
**#**************#**
**#**************#**
**#**************#**
**#**************#**
********************
********************
****############****
********************